I	PP	I
wanna	VBP	wanna
win	VB	win
a	DT	a
Tegra	NP	Tegra
3	CD	3
device	NN	device
from	IN	from
Canon	NP	Canon
USER	NP	USER
and	CC	and
USER	NP	USER
HTC	NP	<unknown>
one	CD	one
x	SYM	x
please	VB	please
I	PP	I
need	VB	need
an	DT	an
upgrade	JJ	upgrade
asap	NN	<unknown>
